A|A|A
AB|AB|AB
ACE|ACE|ACE
ACT|ACT|ACT
ADM|ADM|ADM
AE|AE|AE
AF|AF|AF
AH|AH|AH
AHDB|AHDB|AHDB
AIR|AIR|AIR
AJ|AJ|AJ
AK|AK|AK
AM|AM|AM
AN|AN|AN
AO|AO|AO
AP|AP|AP
AR|AR|AR
ASI|ASI|ASI
ASSI|ASSI|ASSI
AST|AST|AST
AT|AT|AT
AVIA|AVIA|AVIA
AW|AW|AW
AX|AX|AX
AY|AY|AY
B|B|B
BA|BA|BA
BC|BC|BC
BD|BD|BD
BE|BE|BE
BEIS|BEIS|BEIS
BF|BF|BF
BH|BH|BH
BIS|BIS|BIS
BJ|BJ|BJ
BK|BK|BK
BL|BL|BL
BLK|BLK|BLK
BM|BM|BM
BN|BN|BN
BP|BP|BP
BPC|BPC|BPC
BR|BR|BR
BS|BS|BS
BT|BT|BT
BV|BV|BV
BW|BW|BW
BX|BX|BX
BY|BY|BY
C|C|C
CA|CA|CA
CAB|CAB|CAB
CABE|CABE|CABE
CAOG|CAOG|CAOG
CB|CB|CB
CCW|CCW|CCW
CD|CD|CD
CE|CE|CE
CEF|CEF|CEF
CES|CES|CES
CF|CF|CF
CHAR|CHAR|CHAR
CHES|CHES|CHES
CHIL|CHIL|CHIL
CJ|CJ|CJ
CK|CK|CK
CL|CL|CL
CLG|CLG|CLG
CM|CM|CM
CN|CN|CN
CO|CO|CO
COAL|COAL|COAL
COPY|COPY|COPY
COU|COU|COU
CP|CP|CP
CPS|CPS|CPS
CRES|CRES|CRES
CRIM|CRIM|CRIM
CSC|CSC|CSC
CSPR|CSPR|CSPR
CT|CT|CT
CUST|CUST|CUST
CV|CV|CV
CW|CW|CW
CWG|CWG|CWG
CX|CX|CX
CY|CY|CY
D|D|D
DB|DB|DB
DC|DC|DC
DD|DD|DD
DEFE|DEFE|DEFE
DEL|DEL|DEL
DEX|DEX|DEX
DF|DF|DF
DFT|DFT|DFT
DG|DG|DG
DGOV|DGOV|DGOV
DH|DH|DH
DIT|DIT|DIT
DJ|DJ|DJ
DK|DK|DK
DL|DL|DL
DM|DM|DM
DN|DN|DN
DO|DO|DO
DPP|DPP|DPP
DR|DR|DR
DSA|DSA|DSA
DSIR|DSIR|DSIR
DT|DT|DT
DURH|DURH|DURH
DV|DV|DV
DVLA|DVLA|DVLA
DW|DW|DW
DX|DX|DX
DY|DY|DY
E|E|E
EA|EA|EA
EB|EB|EB
EC|EC|EC
ECCL|ECCL|ECCL
ECG|ECG|ECG
ED|ED|ED
EDG|EDG|EDG
EF|EF|EF
EG|EG|EG
EH|EH|EH
EJ|EJ|EJ
EL|EL|EL
EM|EM|EM
EN|EN|EN
EP|EP|EP
ER|ER|ER
ES|ES|ES
ET|ET|ET
EV|EV|EV
EW|EW|EW
EXT|EXT|EXT
EY|EY|EY
F|F|F
FA|FA|FA
FB|FB|FB
FCO|FCO|FCO
FD|FD|FD
FEC|FEC|FEC
FERA|FERA|FERA
FG|FG|FG
FH|FH|FH
FJ|FJ|FJ
FK|FK|FK
FL|FL|FL
FM|FM|FM
FN|FN|FN
FO|FO|FO
FP|FP|FP
FR|FR|FR
FS|FS|FS
FT|FT|FT
FV|FV|FV
FW|FW|FW
FY|FY|FY
GCDA|GCDA|GCDA
GEO|GEO|GEO
GFM|GFM|GFM
GIRO|GIRO|GIRO
GT|GT|GT
GUK|GUK|GUK
HA|HA|HA
HB|HB|HB
HCA|HCA|HCA
HD|HD|HD
HE|HE|HE
HF|HF|HF
HK|HK|HK
HLG|HLG|HLG
HMC|HMC|HMC
HN|HN|HN
HO|HO|HO
HP|HP|HP
HR|HR|HR
HS|HS|HS
HT|HT|HT
HV|HV|HV
HW|HW|HW
HWA|HWA|HWA
HX|HX|HX
HY|HY|HY
IBS|IBS|IBS
ILB|ILB|ILB
IND|IND|IND
INF|INF|INF
IPSA|IPSA|IPSA
IR|IR|IR
J|J|J
JA|JA|JA
JB|JB|JB
JC|JC|JC
JD|JD|JD
JE|JE|JE
JF|JF|JF
JH|JH|JH
JK|JK|JK
JL|JL|JL
JM|JM|JM
JN|JN|JN
JP|JP|JP
JR|JR|JR
JS|JS|JS
JT|JT|JT
JUST|JUST|JUST
JV|JV|JV
JW|JW|JW
JX|JX|JX
JY|JY|JY
KA|KA|KA
KB|KB|KB
KC|KC|KC
KD|KD|KD
KE|KE|KE
KF|KF|KF
KH|KH|KH
KJ|KJ|KJ
KL|KL|KL
KM|KM|KM
KN|KN|KN
KP|KP|KP
KR|KR|KR
KS|KS|KS
KT|KT|KT
KV|KV|KV
KW|KW|KW
KX|KX|KX
KY|KY|KY
LAB|LAB|LAB
LAR|LAR|LAR
LB|LB|LB
LC|LC|LC
LCO|LCO|LCO
LD|LD|LD
LE|LE|LE
LEO|LEO|LEO
LEV|LEV|LEV
LF|LF|LF
LH|LH|LH
LITV|LITV|LITV
LJ|LJ|LJ
LK|LK|LK
LM|LM|LM
LN|LN|LN
LO|LO|LO
LOC|LOC|LOC
LP|LP|LP
LR|LR|LR
LRRO|LRRO|LRRO
LS|LS|LS
LSIS|LSIS|LSIS
LT|LT|LT
LV|LV|LV
LX|LX|LX
LY|LY|LY
MAF|MAF|MAF
MCA|MCA|MCA
MEPO|MEPO|MEPO
MF|MF|MF
MFC|MFC|MFC
MFQ|MFQ|MFQ
MH|MH|MH
MHRA|MHRA|MHRA
MINT|MINT|MINT
MJ|MJ|MJ
MM|MM|MM
MONW|MONW|MONW
MPA|MPA|MPA
MPAA|MPAA|MPAA
MPB|MPB|MPB
MPBB|MPBB|MPBB
MPC|MPC|MPC
MPCC|MPCC|MPCC
MPD|MPD|MPD
MPDD|MPDD|MPDD
MPE|MPE|MPE
MPEE|MPEE|MPEE
MPF|MPF|MPF
MPFF|MPFF|MPFF
MPG|MPG|MPG
MPGG|MPGG|MPGG
MPH|MPH|MPH
MPHH|MPHH|MPHH
MPI|MPI|MPI
MPII|MPII|MPII
MPK|MPK|MPK
MPKK|MPKK|MPKK
MPL|MPL|MPL
MPLL|MPLL|MPLL
MPM|MPM|MPM
MPN|MPN|MPN
MPNN|MPNN|MPNN
MPO|MPO|MPO
MPP|MPP|MPP
MPQ|MPQ|MPQ
MPQQ|MPQQ|MPQQ
MPR|MPR|MPR
MPS|MPS|MPS
MPT|MPT|MPT
MPZ|MPZ|MPZ
MR|MR|MR
MRC|MRC|MRC
MRQ|MRQ|MRQ
MT|MT|MT
MUN|MUN|MUN
NATS|NATS|NATS
NB|NB|NB
NC|NC|NC
NCC|NCC|NCC
NDA|NDA|NDA
NDO|NDO|NDO
NE|NE|NE
NF|NF|NF
NG|NG|NG
NH|NH|NH
NIA|NIA|NIA
NICO|NICO|NICO
NJ|NJ|NJ
NK|NK|NK
NL|NL|NL
NMM|NMM|NMM
NOMS|NOMS|NOMS
NP|NP|NP
NPL|NPL|NPL
NR|NR|NR
NSC|NSC|NSC
NT|NT|NT
NV|NV|NV
NW|NW|NW
NX|NX|NX
NY|NY|NY
OBS|OBS|OBS
OCM|OCM|OCM
OD|OD|OD
OLD|OLD|OLD
OPG|OPG|OPG
OS|OS|OS
OSA|OSA|OSA
PALA|PALA|PALA
PB|PB|PB
PC|PC|PC
PCAP|PCAP|PCAP
PCGN|PCGN|PCGN
PCOM|PCOM|PCOM
PD|PD|PD
PEV|PEV|PEV
PF|PF|PF
PH|PH|PH
PHSO|PHSO|PHSO
PIN|PIN|PIN
PITA|PITA|PITA
PJ|PJ|PJ
PL|PL|PL
PMG|PMG|PMG
PN|PN|PN
POST|POST|POST
POWE|POWE|POWE
PP|PP|PP
PREM|PREM|PREM
PRIS|PRIS|PRIS
PRO|PRO|PRO
PROB|PROB|PROB
PSO|PSO|PSO
PT|PT|PT
PV|PV|PV
PWLB|PWLB|PWLB
PX|PX|PX
PY|PY|PY
QAB|QAB|QAB
QAPS|QAPS|QAPS
QFA|QFA|QFA
QLIB|QLIB|QLIB
QLX|QLX|QLX
QPR|QPR|QPR
RAIL|RAIL|RAIL
RB|RB|RB
RC|RC|RC
RD|RD|RD
RECO|RECO|RECO
REQ|REQ|REQ
RF|RF|RF
RG|RG|RG
RGO|RGO|RGO
RH|RH|RH
RJ|RJ|RJ
RM|RM|RM
RP|RP|RP
RS|RS|RS
RT|RT|RT
RV|RV|RV
RW|RW|RW
SA|SA|SA
SB|SB|SB
SC|SC|SC
SCOT|SCOT|SCOT
SD|SD|SD
SE|SE|SE
SF|SF|SF
SFO|SFO|SFO
SH|SH|SH
SJ|SJ|SJ
SK|SK|SK
SL|SL|SL
SLC|SLC|SLC
SO|SO|SO
SP|SP|SP
SR|SR|SR
ST|ST|ST
STAC|STAC|STAC
STAT|STAT|STAT
SU|SU|SU
SUPP|SUPP|SUPP
SW|SW|SW
T|T|T
TCB|TCB|TCB
TCC|TCC|TCC
TCD|TCD|TCD
TCK|TCK|TCK
TG|TG|TG
TITH|TITH|TITH
TR|TR|TR
TS|TS|TS
TV|TV|TV
UGC|UGC|UGC
UKSC|UKSC|UKSC
UKTI|UKTI|UKTI
VC|VC|VC
VCA|VCA|VCA
VL|VL|VL
VOSA|VOSA|VOSA
WA|WA|WA
WALE|WALE|WALE
WARD|WARD|WARD
WM|WM|WM
WO|WO|WO
WORK|WORK|WORK
ZBOX|ZBOX|ZBOX
ZHC|ZHC|ZHC
ZHL|ZHL|ZHL
ZJ|ZJ|ZJ
ZLIB|ZLIB|ZLIB
ZMAP|ZMAP|ZMAP
ZOS|ZOS|ZOS
ZPER|ZPER|ZPER
ZSPC|ZSPC|ZSPC
ZWEB|ZWEB|ZWEB
